11111111111111111111111
1C00000000C1C00000000E1
10000000000100000000001
10010000000000111111001
100100110000010000C1001
10010011000C10011001001
10010000001000011001001
1001C000010000000001001
10011111100000000001001
10000000000100000000001
1P00000000C1C00000000C1
11111111111111111111111