1111111
1CC00E1
1P00001
1111111