1111111
1CCC0E1
1P00001
1111111