1111111
1CC00E1
1P000C1
1111111