1111111
10C0E01
1P00001
1111111