111111111
10P000001
100000001
10C000001
1000E0001
111111111

